3001111111111111111111111111111
0000000001000000000000000000001
1001111001001111001111111001111
1000001001000001001001000000001
1001111111111001111001001111001
1000000000000000001000001000001
1001001111111111111111001001111
1001000000000001000000001000004